000000000
001022200
011132222
001333422
000034442
055562422
077762222
077768882
007772222