001111222
011133312
111111312
141111311
141111511
144415511
111161117
811661117
881111777