11222222
12234455
13336455
13666444
11177784
44178884
44118444
44444444