00000000
01112223
01444523
06477523
06577523
06555563
06666663
00066333