00011222
01111112
00111122
01111113
45111163
45556663
45756763
44777733