11111112
13334222
13554666
13554446
17555586
17555581
17778881
11111111