11221333
14221333
15511333
15511111
11166611
11166611
77166681
77111111