11122333
12222223
11222233
12222224
56222274
56667774
56867874
55888844