00110222
03110222
04400222
04400000
00055500
00055500
66055570
66000000