111111111
112133311
122243333
112444533
111145553
166673533
188873333
188879993
118883333