11111111
12223334
12555634
17588634
17688634
17666674
17777774
11177444