12222333
11244434
12244444
22244454
22224555
62224777
66227787
62222888