11122222
13332222
13445552
13446652
17776652
11877772
81888222
88888882