111123344
122222334
122252234
222252234
266655224
267665528
227222228
227229998
777999888