112222333
122244423
222222423
252222422
252222622
255526622
222272228
922772228
992222888